R 940 610
F 224,12,110,0
C 11,25,30,110

EA /home/dkarthus/CLionProjects/wolfi/txtrs/WALL2.xpm
WE /home/dkarthus/CLionProjects/wolfi/txtrs/WALL33.xpm
NO /home/dkarthus/CLionProjects/wolfi/txtrs/WALL63.xpm
SO /home/dkarthus/CLionProjects/wolfi/txtrs/WALL75.xpm
S /home/dkarthus/CLionProjects/wolfi/txtrs/pillar.xpm

        1111111111111111111111111
        1000000000110000000000001
        1011000001110000000000011111
        100100000000000000000001111
111111111011000001110000000000001
1000000000110000011110111111111111
11110111111111011101000010001
111100111111110111010100100011
1100000011210121112000000000011111111111111111111111111111111111111111111111111111111111111111111
110010000000000000000000000000000000000000000000000000000000000000000000000000000000000000000000111
11000010000000000000000000202000200020020020002002000200000000000000W000000000000000000000000000001
110010000000000000000000000000000000000000000001000000000000001000000000100000000000000000000000001
111101110111211111121111201200000000000000000000000000000000000000001000000000000000000000000000001
1111111111111111 1111111111111111111111111111111111111111111111111111111111111111111111111111111111