R 1024 920
F 0,220,100,0
C 0,225,30,0

NO /Users/dkarthus/cub3d/path_to_the_north_texture
SO /Users/dkarthus/cub3d/path_to_the_south_texture
WE /Users/dkarthus/cub3d/path_to_the_west_texture
EA /Users/dkarthus/cub3d/path_to_the_east_texture
S /Users/dkarthus/cub3d/path_to_the_sprite_texture

        1111111111111111111111111
        1000000000110000000000001
        1011000001110000000000011111
        100100000000000000000001111
111111111011000001110000000000001
1000000000110000011110111111111111
11110111111111011101000010001
111101111111110111010100100011
110000001101010111000000000001
100020000000000000000000000111
1E000000100000000000000000001
1100000111010101111101111000111
11110111 1110101 101111010001
11111111 1111111 111111111111