R 1080 640
F 12,12,110,0
C 11,25,30,110

NO /home/dkarthus/CLionProjects/wolfi/txtrs/WALL2.xpm
SO /home/dkarthus/CLionProjects/wolfi/txtrs/WALL33.xpm
WE /home/dkarthus/CLionProjects/wolfi/txtrs/WALL63.xpm
EA /home/dkarthus/CLionProjects/wolfi/txtrs/WALL75.xpm
S /home/dkarthus/CLionProjects/wolfi/txtrs/BAR.xpm

        1111111111111111111111111
        1000000000110000000000001
        1011000001110000000000011111
        100100000000000000000001111
111111111011000001110000000000001
1000000000110000011110111111111111
11110111111111011101000010001
111100111111110111010100100011
110000001101010111000000000001
1100S0000000000000000000000111
11000000000000000000000000001
11001000000000000001111000111
11110111011101011101111010001
1111111111111111 111111111111