R 1080 640
F 12,12,110,0
C 11,25,30,110

NO /Users/dkarthus/cub3d/txtrs/WALL2.xpm
SO /Users/dkarthus/cub3d/txtrs/WALL33.xpm
WE /Users/dkarthus/cub3d/txtrs/WALL63.xpm
EA /Users/dkarthus/cub3d/txtrs/WALL75.xpm
S /Users/dkarthus/cub3d/txtrs/BAR.xpm

        1111111111111111111111111
        1000000000110000000000001
        1011000001110000000000011111
        100100000000000000000001111
111111111011000001110000000000001
1000000000110000011110111111111111
11111111111111011101000010001
111111111111110111010100100011
110000001101010111000000000001
1000N0001000000000000000000111
10000000100000000000000000001
1100000111010101111101111000111
1111011121110101 101111010001
1111111111111111 111111111111